NO ./assets/textures/redbrick.png
SO ./assets/textures/eagle.png
WE ./assets/textures/bluestone.png
EA ./assets/textures/colorstone.png

C 48,46,42
F 135,206,235

111111111111111111111111
100000000000000010000001
101000000000000000000001
101001000000000000000001
101000000000000010000001
101000000000000011011111
101000010101010110001111
111100010000000110000001
  10101000000000000000111111
111100010000N00110000001
100000010000000110001111
100000011110111111111111
111111111110111111111111
100000000000000000000001
111111011110111111111111
111111011110111111111111
100000000110110000010001
100000000000110010010001
100000000110110000011011
101010000110000010000001
100100000110110000011011
101010000110110010010001
100000000110110000010001
111111111111111111111111